0000000000000000000000000000000
0111111111111101111111110111110
0100000000000101000000010100010
0101111111110101110111111101110
0101010000010100000100000000000
0101011111010111110101111111010
0101000001010000010101000001010
0101110111010111011101011101010
0100010100010100000001010101010
0111010101110101111111010101010
0100010001000101000000010101010
0111010111011101011111010111110
0001010100000101010101010000000
0111010101110101010101011101110
0100010101010101010101010101010
1111110101011101110101010101011
0000010101000000000101010101000
0111010101111111011101010101010
0101010100000100010001010101010
0101110111110101110111010101010
0100000000010101000100010101010
0101011111110101011101110101010
0101010000000101010001000101010
0111010111111101011101010101010
0000010100000001000101010101010
0111110111110111011101011101010
0100000000010101010001000001010
0111111111011101010101111111010
0100000001000001010100000000010
0111111101111111011111111111110
0000000000000000000000000000000